111111111111111111111111
100000000000000000000001
100000000C00000000000001
100000000000000000000001
1000C0000000000000000001
100000000000000000000001
1P00000000000000000E0001
111111111111111111111111