111111111111111111111111
100000000000000000000001
100000000000000000000001
100000000000000E00000001
1000C0000000000000000001
100000000000000000000001
1P0000000000000000000001
111111111111111111111111